111111111111
100000000001
100000000001
100000000001
100000000001
100000000001
100000000001
100000000001
1000P0C000E1
111111111111