111111111111111111111111111111111111111
1C0100000000000000011110000000001000001
1C00P000N000110C000010100000C00010000C1
100011100000010000000000000010001000101
1000000C0000110C01000000001111000001001
1000CC100000100000011110001000C00111001
110011000C00001110000010000000000000001
1C0111000000000000000011100000010111101
100001000C0010000000100C001100000000001
100C000000000001111000000000000000000E1
111111111111111111111111111111111111111